 #       #
 #  # ## #
 ## # ## #
 #p #    #
       ###
#        #
         #
 ## #### #
 #       #
 #########